########## ##########
#          ##########
# ## #####       ####
#### #####  #### ####
#    ###### #### ####
#  ###      ####    #
#  ### ############ #
###### #####        #
###### ############ #
######         #### #
############## #### #
############## ######